10 10
.f........
...f..f..a
..........
..a.......
..........
.......f..
..........
........h.
..........
s.........
